راجل	راجل	راجل
الراجل	الراجل	الراجل
{الراجل دة}	الراجل دة	الراجل_دة
هو ذكي	هو ذكي	هو_ذكي
الراجل دة ذكي	الراجل دة ذكي	الراجل_دة_ذكي
هو طيب	هو طيب	هو_طيب
الراجل دة طيب	الراجل دة طيب	الراجل_دة_طيب
هو طويل	هو طويل	هو_طويل
الراجل دة طويل	الراجل دة طويل	الراجل_دة_طويل
راجل ذكي	راجل ذكي	راجل_ذكي
الراجل الذكي دة	الراجل الذكي دة	الراجل_الذكي_دة
راجل طيب	راجل طيب	راجل_طيب
الراجل الطيب دة	الراجل الطيب دة	الراجل_الطيب_دة
راجل طويل	راجل طويل	راجل_طويل
الراجل الطويل دة	الراجل الطويل دة	الراجل_الطويل_دة
هو بيقرا	هو بيقرا	هو_بيقرا
الراجل دة بيقرا	الراجل دة بيقرا	الراجل_دة_بيقرا
هو بياكل	هو بياكل	هو_بياكل
الراجل دة بياكل	الراجل دة بياكل	الراجل_دة_بياكل
هو بيشرب	هو بيشرب	هو_بيشرب
الراجل دة بيشرب	الراجل دة بيشرب	الراجل_دة_بيشرب
هو بيغني	هو بيغني	هو_بيغني
الراجل اللي بيغني	الراجل اللي بيغني	الراجل_اللي_بيغني
هو بيطبخ	هو بيطبخ	هو_بيطبخ
الراجل اللي بيطبخ	الراجل اللي بيطبخ	الراجل_اللي_بيطبخ
هو بيعوم	هو بيعوم	هو_بيعوم
الراجل اللي بيعوم	الراجل اللي بيعوم	الراجل_اللي_بيعوم
هو مدرس	هو مدرس	هو_مدرس
الراجل دة مدرس	الراجل دة مدرس	الراجل_دة_مدرس
هو دكتور	هو دكتور	هو_دكتور
الراجل دة دكتور	الراجل دة دكتور	الراجل_دة_دكتور
هو مترجم	هو مترجم	هو_مترجم
الراجل دة مترجم	الراجل دة مترجم	الراجل_دة_مترجم
بابا	بابا	بابا
باباه	باباه	باباه
باباها	باباها	باباها
باباك ٪ باباكي	باباك باباكي	باباك_باباكي
بابا مدرس	بابا مدرس	بابا_مدرس
بابا دكتور	بابا دكتور	بابا_دكتور
بابا مترجم	بابا مترجم	بابا_مترجم
بابا مدرس	بابا مدرس	بابا_مدرس
باباك مدرس ٪ باباكي مدرس	باباك مدرس باباكي مدرس	باباك_مدرس_باباكي_مدرس
قطة	قطة	قطة
القطة	القطة	القطة
القطة دي	القطة دي	القطة_دي
قطتي	قطتي	قطتي
قطتك ٪ قطتِك ٪ قطتكم	قطتك قطت ك قطتكم	قطتك_قطت_ك_قطتكم
قطتنا	قطتنا	قطتنا
قطته	قطته	قطته
قطتها	قطتها	قطتها
قطتهم	قطتهم	قطتهم
قطة كبيرة	قطة كبيرة	قطة_كبيرة
قطتي كبيرة	قطتي كبيرة	قطتي_كبيرة
قطة سودة	قطة سودة	قطة_سودة
قطته سودة	قطته سودة	قطته_سودة
قطة صغيرة	قطة صغيرة	قطة_صغيرة
قطتها صغيرة	قطتها صغيرة	قطتها_صغيرة
كلب	كلب	كلب
الكلب	الكلب	الكلب
الكلب دة	الكلب دة	الكلب_دة
كلبي	كلبي	كلبي
كلب بابا	كلب بابا	كلب_بابا
كلبه	كلبه	كلبه
كلب باباه	كلب باباه	كلب_باباه
كلبها	كلبها	كلبها
كلب باباها	كلب باباها	كلب_باباها
شنطة	شنطة	شنطة
الشنطة	الشنطة	الشنطة
الشنطة دي	الشنطة دي	الشنطة_دي
عاوز شنطة	عاوز شنطة	عاوز_شنطة
هو عاوز شنطة	هو عاوز شنطة	هو_عاوز_شنطة
عاوز عربية	عاوز عربية	عاوز_عربية
هو عاوز عربية	هو عاوز عربية	هو_عاوز_عربية
عاوز بيت	عاوز بيت	عاوز_بيت
هو عاوز بيت	هو عاوز بيت	هو_عاوز_بيت
ست	ست	ست
الست	الست	الست
الست دي	الست دي	الست_دي
هي عاوزة عربية	هي عاوزة عربية	هي_عاوزة_عربية
الست دي عاوزة عربية	الست دي عاوزة عربية	الست_دي_عاوزة_عربية
هي عاوزة شنطة	هي عاوزة شنطة	هي_عاوزة_شنطة
الست دي عاوزة شنطة	الست دي عاوزة شنطة	الست_دي_عاوزة_شنطة
هي عاوزة بيت	هي عاوزة بيت	هي_عاوزة_بيت
الست دي عاوزة بيت	الست دي عاوزة بيت	الست_دي_عاوزة_بيت
بيت	بيت	بيت
البيت	البيت	البيت
البيت دة	البيت دة	البيت_دة
{بيت جديد}	بيت جديد	بيت_جديد
البيت دة جديد	البيت دة جديد	البيت_دة_جديد
{بيت قديم}	بيت قديم	بيت_قديم
البيت دة قديم	البيت دة قديم	البيت_دة_قديم
بيت حلو	بيت حلو	بيت_حلو
البيت دة حلو	البيت دة حلو	البيت_دة_حلو
عاوزين بيت	عاوزين بيت	عاوزين_بيت
عاوزين بيت جديد	عاوزين بيت جديد	عاوزين_بيت_جديد
هما عاوزين بيت	هما عاوزين بيت	هما_عاوزين_بيت
هما عاوزين بيت جديد	هما عاوزين بيت جديد	هما_عاوزين_بيت_جديد
عاوزين بيت حلو	عاوزين بيت حلو	عاوزين_بيت_حلو
هما عاوزين بيت حلو	هما عاوزين بيت حلو	هما_عاوزين_بيت_حلو
إيه؟	إيه	إيه
فين؟	فين	فين
إمتى؟	إمتى	إمتى
مين؟	مين	مين
ليه؟	ليه	ليه
إزاي؟	إزاي	إزاي
بكام؟	بكام	بكام
رجالة	رجالة	رجالة
الرجالة	الرجالة	الرجالة
الرجالة دول	الرجالة دول	الرجالة_دول
عاوز إيه؟	عاوز إيه	عاوز_إيه
هي عاوزة إيه؟	هي عاوزة إيه	هي_عاوزة_إيه
الست دي عاوزة إيه؟	الست دي عاوزة إيه	الست_دي_عاوزة_إيه
هو عاوز إيه؟	هو عاوز إيه	هو_عاوز_إيه
الراجل دة عاوز إيه؟	الراجل دة عاوز إيه	الراجل_دة_عاوز_إيه
هما عاوزين إيه؟	هما عاوزين إيه	هما_عاوزين_إيه
الرجالة دول عاوزين إيه؟	الرجالة دول عاوزين إيه	الرجالة_دول_عاوزين_إيه
شوربة	شوربة	شوربة
رز	رز	رز
مكرونة	مكرونة	مكرونة
عيش	عيش	عيش
سلطة	سلطة	سلطة
جبنة	جبنة	جبنة
فراخ	فراخ	فراخ
لحمة	لحمة	لحمة
خضار	خضار	خضار
سمك	سمك	سمك
فاكهة	فاكهة	فاكهة
لحمة خنزير	لحمة خنزير	لحمة_خنزير
هو	هو	هو
هي	هي	هي
أنا	أنا	أنا
إحنا	إحنا	إحنا
هما	هما	هما
إنت ٪ إنتي ٪ إنتو ٪ حضرتك ٪ حضرتِك	إنت إنتي إنتو حضرتك حضرت ك	إنت_إنتي_إنتو_حضرتك_حضرت_ك
هو ٪ هي	هو هي	هو_هي
إيه دة؟	إيه دة	إيه_دة
إيه اللي حصل؟	إيه اللي حصل	إيه_اللي_حصل
إيه تاني؟	إيه تاني	إيه_تاني
في مشكلة؟	في مشكلة	في_مشكلة
		
		
		
		
		
		
		
		
		
		
		
باكل مكرونة	باكل مكرونة	باكل_مكرونة
		
		
		
		
		
		
		
		
		
		
		
		
		
		
		
		
		
		
		
		
مين هو؟	مين هو	مين_هو
مين الراجل دة؟	مين الراجل دة	مين_الراجل_دة
مين هي؟	مين هي	مين_هي
مين الست دي؟	مين الست دي	مين_الست_دي
مين دول؟	مين دول	مين_دول
مين الرجالة دول؟	مين الرجالة دول	مين_الرجالة_دول
		
		
		
		
		
هو بيتكلم إنجليزي	هو بيتكلم إنجليزي	هو_بيتكلم_إنجليزي
ناس	ناس	ناس
		
		
		
		
		
		
		
		
		
		
		
		
		
		
		
		
اسمي	اسمي	اسمي
اسمه	اسمه	اسمه
اسمها	اسمها	اسمها
		
		
اسمه إيه؟	اسمه إيه	اسمه_إيه
اسمعا إيه؟	اسمعا إيه	اسمعا_إيه
اسمي آدم	اسمي آدم	اسمي_آدم
اسمي سارة	اسمي سارة	اسمي_سارة
اسمه آدم	اسمه آدم	اسمه_آدم
		
		
		
		
		
		
		
		
		
		
		
		
		
		
		
		
		
		
		
		
		
		
		
		
		
		
		
		
		
		
		
		
		
		
		
		
		
		
		
		
		
		
		
		
		
		
		
		
عربية	عربية	عربية
		
		
		
		
		
		
عندها قطة	عندها قطة	عندها_قطة
		
		
		
		
عندنا قطة	عندنا قطة	عندنا_قطة
		
		
		
		
		
		
		
		
		
		
		
		
		
		
		
		
		
		
		
		
		
		
		
		
		
		
		
		
		
		
		
		
		
		
		
أنا فين؟	أنا فين	أنا_فين
		
الحمام فين؟	الحمام فين	الحمام_فين
		
		
		
		
		
		
		
		
		
		
		
		
		
		
		
		
		
		
		
		
		
		
		
		
		
		
		
		
		
		
		
		
		
		
		
		
		
		
		
		
		
		
		
		
		
		
قطر	قطر	قطر
		
		
		
		
		
		
		
		
		
		
		
		
		
		
		
		
		
		
		
		
		
		
		
		
		
		
		
		
		
		
		
		
		
		
		
		
		
		
		
		
		
		
		
		
		
		
		
		
		
		
		
		
		
		
		
		
		
		
		
		
		
		
		
		
		
		
		
		
		
		
		
		
		
		
		
		
		
		
		
		
		
		
		
		
		
		
مدرس طويل	مدرس طويل	مدرس_طويل
مدرس ذكي	مدرس ذكي	مدرس_ذكي
المدرس الذكي	المدرس الذكي	المدرس_الذكي
الراجل الطويل	الراجل الطويل	الراجل_الطويل
المدرس الذكي	المدرس الذكي	المدرس_الذكي
المدرس دة ذكي	المدرس دة ذكي	المدرس_دة_ذكي
المدرس الطويل دة	المدرس الطويل دة	المدرس_الطويل_دة
المدرس دة طويل	المدرس دة طويل	المدرس_دة_طويل
المدرس الطويل دة ذكي	المدرس الطويل دة ذكي	المدرس_الطويل_دة_ذكي
الراجل الذكي دة طويل	الراجل الذكي دة طويل	الراجل_الذكي_دة_طويل
صباح الخير! <br> صباح النور	صباح الخير br صباح النور	صباح_الخير_br_صباح_النور
مساء الخير! <br> مساء النور	مساء الخير br مساء النور	مساء_الخير_br_مساء_النور
إزيك؟ <br> كويس، شكرا	إزيك br كويس شكرا	إزيك_br_كويس_شكرا
شكرا! <br> العفو	شكرا br العفو	شكرا_br_العفو
إسمك إيه؟ <br> إسمي آدم	إسمك إيه br إسمي آدم	إسمك_إيه_br_إسمي_آدم
أتوبيس	أتوبيس	أتوبيس
طيارة	طيارة	طيارة
سفينة	سفينة	سفينة
عندي كلب	عندي كلب	عندي_كلب
عندي قطة	عندي قطة	عندي_قطة
عندي حصان	عندي حصان	عندي_حصان
عندنا حصان	عندنا حصان	عندنا_حصان
عندها كلب	عندها كلب	عندها_كلب
عنده كلب	عنده كلب	عنده_كلب
عنده حصان	عنده حصان	عنده_حصان
المدرس دة عنده حصان	المدرس دة عنده حصان	المدرس_دة_عنده_حصان
المدرس دة عنده كلب	المدرس دة عنده كلب	المدرس_دة_عنده_كلب
عندك كلب	عندك كلب	عندك_كلب
عندك قطة	عندك قطة	عندك_قطة
سمكة	سمكة	سمكة
بقرة	بقرة	بقرة
طائر	طائر	طائر
إنتا منين؟ <br> أنا من فرنسا	إنتا منين br أنا من فرنسا	إنتا_منين_br_أنا_من_فرنسا
عندك كام سنة؟ <br> عندي عشرين سنة	عندك كام سنة br عندي عشرين سنة	عندك_كام_سنة_br_عندي_عشرين_سنة
عاوز إيه؟ <br> عاوز آكل	عاوز إيه br عاوز آكل	عاوز_إيه_br_عاوز_آكل
بتدور على إيه؟ <br> بدور على مطعم	بتدور على إيه br بدور على مطعم	بتدور_على_إيه_br_بدور_على_مطعم
ولد	ولد	ولد
بنت	بنت	بنت
عاوزين عربية	عاوزين عربية	عاوزين_عربية
الراجل دة عاوز بيت	الراجل دة عاوز بيت	الراجل_دة_عاوز_بيت
الراجل دة عاوز عربية	الراجل دة عاوز عربية	الراجل_دة_عاوز_عربية
إنتا عاوز عربية	إنتا عاوز عربية	إنتا_عاوز_عربية
إنتا عاوز بيت	إنتا عاوز بيت	إنتا_عاوز_بيت
{(مشكلة) [صغيرة]}	صغيرة	مشكلة_صغيرة
{مشكلة كبيرة}	مشكلة كبيرة	مشكلة_كبيرة
{مشكلة تانية}	مشكلة تانية	مشكلة_تانية
{بيت كبير}	بيت كبير	بيت_كبير
{أسئلة تانية}	أسئلة تانية	أسئلة_تانية
{أسئلة كويسة}	أسئلة كويسة	أسئلة_كويسة
{أسئلة كتيرة}	أسئلة كتيرة	أسئلة_كتيرة
{عربية قديمة}	عربية قديمة	عربية_قديمة
{عربية حلوة}	عربية حلوة	عربية_حلوة
{عربية جديدة}	عربية جديدة	عربية_جديدة
{الشخص دة}	الشخص دة	الشخص_دة
{رقم التليفون بتاعي}	رقم التليفون بتاعي	رقم_التليفون_بتاعي
{العنوان الجديد بتاعي}	العنوان الجديد بتاعي	العنوان_الجديد_بتاعي
{الباسبور بتاعي}	الباسبور بتاعي	الباسبور_بتاعي
الجواب وصل	الجواب وصل	الجواب_وصل
الناس وصلوا	الناس وصلوا	الناس_وصلوا
الضيوف وصلوا	الضيوف وصلوا	الضيوف_وصلوا
هو عاوز تذكرة	هو عاوز تذكرة	هو_عاوز_تذكرة
باكل فراخ	باكل فراخ	باكل_فراخ
باكل جبنة	باكل جبنة	باكل_جبنة
شفت الأتوبيس	شفت الأتوبيس	شفت_الأتوبيس
شفت القطر	شفت القطر	شفت_القطر
شفت الطيارة	شفت الطيارة	شفت_الطيارة
عندي مشكلة صغيرة	عندي مشكلة صغيرة	عندي_مشكلة_صغيرة
عندنا مشكلة كبيرة	عندنا مشكلة كبيرة	عندنا_مشكلة_كبيرة
عندها مشكلة تانية	عندها مشكلة تانية	عندها_مشكلة_تانية
عندنا بيت كبير	عندنا بيت كبير	عندنا_بيت_كبير
عنده بيت جديد	عنده بيت جديد	عنده_بيت_جديد
عندهم بيت قديم	عندهم بيت قديم	عندهم_بيت_قديم
عندك أسئلة تانية	عندك أسئلة تانية	عندك_أسئلة_تانية
عندهم أسئلة كويسة	عندهم أسئلة كويسة	عندهم_أسئلة_كويسة
عندنا أسئلة كتيرة	عندنا أسئلة كتيرة	عندنا_أسئلة_كتيرة
الست دي عندها مطبخ جديد	الست دي عندها مطبخ جديد	الست_دي_عندها_مطبخ_جديد
الراجل دة عنده عربية قديمة	الراجل دة عنده عربية قديمة	الراجل_دة_عنده_عربية_قديمة
الشخص دة عنده عربية حلوة	الشخص دة عنده عربية حلوة	الشخص_دة_عنده_عربية_حلوة
ما عندهاش عربية جديدة	ما عندهاش عربية جديدة	ما_عندهاش_عربية_جديدة
ما عندهمش أسئلة تانية	ما عندهمش أسئلة تانية	ما_عندهمش_أسئلة_تانية
ما عنديش أي مشكلة	ما عنديش أي مشكلة	ما_عنديش_أي_مشكلة
الست دي معندهاش عربية حلوة	الست دي معندهاش عربية حلوة	الست_دي_معندهاش_عربية_حلوة
الراجل دة ما عندوش عربية قديمة	الراجل دة ما عندوش عربية قديمة	الراجل_دة_ما_عندوش_عربية_قديمة
الشخص دة ما عندوش عربية جديدة	الشخص دة ما عندوش عربية جديدة	الشخص_دة_ما_عندوش_عربية_جديدة
أنا المدرس الجديد	أنا المدرس الجديد	أنا_المدرس_الجديد
أنا المدير الجديد	أنا المدير الجديد	أنا_المدير_الجديد
أنا المترجم الجديد	أنا المترجم الجديد	أنا_المترجم_الجديد
هو في المدرسة دلوقتي	هو في المدرسة دلوقتي	هو_في_المدرسة_دلوقتي
هي في المطار دلوقتي	هي في المطار دلوقتي	هي_في_المطار_دلوقتي
هم في المستشفى دلوقتي	هم في المستشفى دلوقتي	هم_في_المستشفى_دلوقتي
إنت طيب جدا (m) % إنتم طيبين جدا (p)	إنت طيب جدا%إنتم طيبين جدا	إنت_طيب_جدا_m%إنتم_طيبين_جدا_p
هي جميلة جدا	هي جميلة جدا	هي_جميلة_جدا
إحنا مبسوطين جدا	إحنا مبسوطين جدا	إحنا_مبسوطين_جدا
جيراننا مزعجين جدا	جيراننا مزعجين جدا	جيراننا_مزعجين_جدا
صاحبي ذكي جدا	صاحبي ذكي جدا	صاحبي_ذكي_جدا
زمايلنا هاديين جدا	زمايلنا هاديين جدا	زمايلنا_هاديين_جدا
معظم الناس طيبين	معظم الناس طيبين	معظم_الناس_طيبين
معظم الأطفال أذكيا	معظم الأطفال أذكيا	معظم_الأطفال_أذكيا
معظم الكتب جديدة	معظم الكتب جديدة	معظم_الكتب_جديدة
أنا من بلد تانية	أنا من بلد تانية	أنا_من_بلد_تانية
هو من مكان تاني	هو من مكان تاني	هو_من_مكان_تاني
هما من مدينة تانية	هما من مدينة تانية	هما_من_مدينة_تانية
الكتاب مش كويس	الكتاب مش كويس	الكتاب_مش_كويس
الأكل مش نضيف	الأكل مش نضيف	الأكل_مش_نضيف
الأتوبيس مش وحش	الأتوبيس مش وحش	الأتوبيس_مش_وحش
شكرا جدا على المساعدة! <br> العفو	شكرا جدا على المساعدة br العفو	شكرا_جدا_على_المساعدة_br_العفو
شكرا على الأكل الحلو دة! <br> العفو	شكرا على الأكل الحلو دة br العفو	شكرا_على_الأكل_الحلو_دة_br_العفو
شكرا على الفكرة دي! <br> العفو	شكرا على الفكرة دي br العفو	شكرا_على_الفكرة_دي_br_العفو
آسف على الإزعاج <br> ولا يهمك	آسف على الإزعاج br ولا يهمك	آسف_على_الإزعاج_br_ولا_يهمك
آسف إني عملت كدة <br> ولا يهمك	آسف إني عملت كدة br ولا يهمك	آسف_إني_عملت_كدة_br_ولا_يهمك
آسف إني سألت السؤال دة <br> ولا يهمك	آسف إني سألت السؤال دة br ولا يهمك	آسف_إني_سألت_السؤال_دة_br_ولا_يهمك
عامل إيه؟ <br> أنا كويس، شكرا	عامل إيه br أنا كويس شكرا	عامل_إيه_br_أنا_كويس_شكرا
عامل إيه دلوقتي؟ <br> أحسن كتير، شكرا	عامل إيه دلوقتي br أحسن كتير شكرا	عامل_إيه_دلوقتي_br_أحسن_كتير_شكرا
أهلا! إسمي آدم	أهلا إسمي آدم	أهلا_إسمي_آدم
أهلا! اسمك إيه؟	أهلا اسمك إيه	أهلا_اسمك_إيه
أهلا! إنت منين؟	أهلا إنت منين	أهلا_إنت_منين
بعد إذنك، ممكن تساعدني؟	بعد إذنك ممكن تساعدني	بعد_إذنك_ممكن_تساعدني
بعد إذنك، ممكن توريني حاجة؟	بعد إذنك ممكن توريني حاجة	بعد_إذنك_ممكن_توريني_حاجة
بعد إذنك، ممكن تتكلم بالراحة؟	بعد إذنك ممكن تتكلم بالراحة	بعد_إذنك_ممكن_تتكلم_بالراحة
من فضلك إديني شوية أكل.	من فضلك إديني شوية أكل	من_فضلك_إديني_شوية_أكل
من فضلك أنا محتاج شوية مية.	من فضلك أنا محتاج شوية مية	من_فضلك_أنا_محتاج_شوية_مية
من فضلك أنا محتاج مكان أنام فيه.	من فضلك أنا محتاج مكان أنام فيه	من_فضلك_أنا_محتاج_مكان_أنام_فيه
اتفضل رقم التليفون بتاعي	اتفضل رقم التليفون بتاعي	اتفضل_رقم_التليفون_بتاعي
اتفضل العنوان الجديد بتاعي	اتفضل العنوان الجديد بتاعي	اتفضل_العنوان_الجديد_بتاعي
اتفضل الباسبور بتاعي	اتفضل الباسبور بتاعي	اتفضل_الباسبور_بتاعي
البيت بتاعك فين؟	البيت بتاعك فين	البيت_بتاعك_فين
الأوضة بتاعتي فين؟	الأوضة بتاعتي فين	الأوضة_بتاعتي_فين
ممكن أتكلم في التليفون؟	ممكن أتكلم في التليفون	ممكن_أتكلم_في_التليفون
ممكن لو سمحت تساعدني؟	ممكن لو سمحت تساعدني	ممكن_لو_سمحت_تساعدني
عاوز أروح الفندق	عاوز أروح الفندق	عاوز_أروح_الفندق
عاوز أروح البيت	عاوز أروح البيت	عاوز_أروح_البيت
عاوز أروح الحمام	عاوز أروح الحمام	عاوز_أروح_الحمام
هي عاوزة شنطة خضرا	هي عاوزة شنطة خضرا	هي_عاوزة_شنطة_خضرا
هو عاوز شنطة سودة	هو عاوز شنطة سودة	هو_عاوز_شنطة_سودة
هما عاوزين عربية سودا	هما عاوزين عربية سودا	هما_عاوزين_عربية_سودا
البنت دي عاوزة تاكل حاجة	البنت دي عاوزة تاكل حاجة	البنت_دي_عاوزة_تاكل_حاجة
الولد دة عاوز يشرب حاجة	الولد دة عاوز يشرب حاجة	الولد_دة_عاوز_يشرب_حاجة
الراجل دة عاوز يعرف حاجة	الراجل دة عاوز يعرف حاجة	الراجل_دة_عاوز_يعرف_حاجة
الولاد عاوزين يلعبوا	الولاد عاوزين يلعبوا	الولاد_عاوزين_يلعبوا
البنات عاوزين يلعبوا	البنات عاوزين يلعبوا	البنات_عاوزين_يلعبوا
الأطفال عاوزين يلعبوا	الأطفال عاوزين يلعبوا	الأطفال_عاوزين_يلعبوا
مش عاوز شنطة جديدة	مش عاوز شنطة جديدة	مش_عاوز_شنطة_جديدة
مش عاوز عربية كبيرة	مش عاوز عربية كبيرة	مش_عاوز_عربية_كبيرة
مش عاوز عربية جديدة	مش عاوز عربية جديدة	مش_عاوز_عربية_جديدة
الناس دول عاوزين ياكلوا؟	الناس دول عاوزين ياكلوا	الناس_دول_عاوزين_ياكلوا
الست دي عاوزة تلعب؟	الست دي عاوزة تلعب	الست_دي_عاوزة_تلعب
الرجالة دول عاوزين يشربوا؟	الرجالة دول عاوزين يشربوا	الرجالة_دول_عاوزين_يشربوا
		
		
		
		
		
		
		
		
		
		
		
		
		
		
		
		
		
		
		
		
		
		
		
		
		
		
		
		
		
		
		
		
		
		
		
		
		
		
		
		
		
		
		
		
		
		
		
		
		
		
		
		
		
		
		
		
		
		
		
		
		
		
		
		
		
		
		
		
		
		
		
		
		
		
		
		
		
		
		
		
		
		
		
		
		
		
		
		
		
		
		
		
		
		
		
		